"filename", "language", "Markdown", "JSON", "Dart", "comment", "blank", "total"
"/Users/carltonaikins/Desktop/Home/Programming/projects/budgetme/.vscodecounter/2022-07-12_14-51-29/details.md", "Markdown", 235, 0, 0, 0, 6, 241
"/Users/carltonaikins/Desktop/Home/Programming/projects/budgetme/.vscodecounter/2022-07-12_14-51-29/diff-details.md", "Markdown", 9, 0, 0, 0, 6, 15
"/Users/carltonaikins/Desktop/Home/Programming/projects/budgetme/.vscodecounter/2022-07-12_14-51-29/diff.md", "Markdown", 12, 0, 0, 0, 7, 19
"/Users/carltonaikins/Desktop/Home/Programming/projects/budgetme/.vscodecounter/2022-07-12_14-51-29/results.json", "JSON", 0, 1, 0, 0, 0, 1
"/Users/carltonaikins/Desktop/Home/Programming/projects/budgetme/.vscodecounter/2022-07-12_14-51-29/results.md", "Markdown", 113, 0, 0, 0, 7, 120
"/Users/carltonaikins/Desktop/Home/Programming/projects/budgetme/budgetme_mobileapp/android/app/google-services.json", "JSON", 0, 36, 0, 0, 0, 36
"/Users/carltonaikins/Desktop/Home/Programming/projects/budgetme/budgetme_mobileapp/lib/l10n/_messages_all.dart", "Dart", 0, 0, 84, 11, 10, 105
"/Users/carltonaikins/Desktop/Home/Programming/projects/budgetme/budgetme_mobileapp/lib/l10n/_messages_ar.dart", "Dart", 0, 0, 27, 11, 9, 47
"/Users/carltonaikins/Desktop/Home/Programming/projects/budgetme/budgetme_mobileapp/lib/l10n/_messages_de.dart", "Dart", 0, 0, 27, 11, 9, 47
"/Users/carltonaikins/Desktop/Home/Programming/projects/budgetme/budgetme_mobileapp/lib/l10n/_messages_en.dart", "Dart", 0, 0, 27, 11, 9, 47
"/Users/carltonaikins/Desktop/Home/Programming/projects/budgetme/budgetme_mobileapp/lib/l10n/_messages_es.dart", "Dart", 0, 0, 27, 11, 9, 47
"/Users/carltonaikins/Desktop/Home/Programming/projects/budgetme/budgetme_mobileapp/lib/l10n/_messages_fr.dart", "Dart", 0, 0, 27, 11, 9, 47
"/Users/carltonaikins/Desktop/Home/Programming/projects/budgetme/budgetme_mobileapp/lib/l10n/_messages_he.dart", "Dart", 0, 0, 27, 11, 9, 47
"/Users/carltonaikins/Desktop/Home/Programming/projects/budgetme/budgetme_mobileapp/lib/l10n/_messages_ja.dart", "Dart", 0, 0, 27, 11, 9, 47
"/Users/carltonaikins/Desktop/Home/Programming/projects/budgetme/budgetme_mobileapp/lib/l10n/_messages_ko.dart", "Dart", 0, 0, 27, 11, 9, 47
"/Users/carltonaikins/Desktop/Home/Programming/projects/budgetme/budgetme_mobileapp/lib/l10n/_messages_pt.dart", "Dart", 0, 0, 27, 11, 9, 47
"/Users/carltonaikins/Desktop/Home/Programming/projects/budgetme/budgetme_mobileapp/lib/l10n/_messages_ru.dart", "Dart", 0, 0, 27, 11, 9, 47
"/Users/carltonaikins/Desktop/Home/Programming/projects/budgetme/budgetme_mobileapp/lib/l10n/_messages_zh.dart", "Dart", 0, 0, 27, 11, 9, 47
"/Users/carltonaikins/Desktop/Home/Programming/projects/budgetme/budgetme_mobileapp/lib/l10n/intl_ar.arb", "JSON", 0, 5, 0, 0, 0, 5
"/Users/carltonaikins/Desktop/Home/Programming/projects/budgetme/budgetme_mobileapp/lib/l10n/intl_de.arb", "JSON", 0, 5, 0, 0, 0, 5
"/Users/carltonaikins/Desktop/Home/Programming/projects/budgetme/budgetme_mobileapp/lib/l10n/intl_en.arb", "JSON", 0, 5, 0, 0, 1, 6
"/Users/carltonaikins/Desktop/Home/Programming/projects/budgetme/budgetme_mobileapp/lib/l10n/intl_es.arb", "JSON", 0, 5, 0, 0, 0, 5
"/Users/carltonaikins/Desktop/Home/Programming/projects/budgetme/budgetme_mobileapp/lib/l10n/intl_fr.arb", "JSON", 0, 5, 0, 0, 0, 5
"/Users/carltonaikins/Desktop/Home/Programming/projects/budgetme/budgetme_mobileapp/lib/l10n/intl_he.arb", "JSON", 0, 5, 0, 0, 0, 5
"/Users/carltonaikins/Desktop/Home/Programming/projects/budgetme/budgetme_mobileapp/lib/l10n/intl_ja.arb", "JSON", 0, 5, 0, 0, 0, 5
"/Users/carltonaikins/Desktop/Home/Programming/projects/budgetme/budgetme_mobileapp/lib/l10n/intl_ko.arb", "JSON", 0, 5, 0, 0, 0, 5
"/Users/carltonaikins/Desktop/Home/Programming/projects/budgetme/budgetme_mobileapp/lib/l10n/intl_pt.arb", "JSON", 0, 5, 0, 0, 0, 5
"/Users/carltonaikins/Desktop/Home/Programming/projects/budgetme/budgetme_mobileapp/lib/l10n/intl_ru.arb", "JSON", 0, 5, 0, 0, 0, 5
"/Users/carltonaikins/Desktop/Home/Programming/projects/budgetme/budgetme_mobileapp/lib/l10n/intl_zh.arb", "JSON", 0, 5, 0, 0, 0, 5
"/Users/carltonaikins/Desktop/Home/Programming/projects/budgetme/budgetme_mobileapp/lib/l10n/l10n.dart", "Dart", 0, 0, -38, -18, -1, -57
"/Users/carltonaikins/Desktop/Home/Programming/projects/budgetme/budgetme_mobileapp/lib/l10n/messages_all.dart", "Dart", 0, 0, 0, -20, -1, -21
"/Users/carltonaikins/Desktop/Home/Programming/projects/budgetme/budgetme_mobileapp/lib/l10n/messages_ar.dart", "Dart", 0, 0, 0, -18, -1, -19
"/Users/carltonaikins/Desktop/Home/Programming/projects/budgetme/budgetme_mobileapp/lib/l10n/messages_de.dart", "Dart", 0, 0, 0, -18, -1, -19
"/Users/carltonaikins/Desktop/Home/Programming/projects/budgetme/budgetme_mobileapp/lib/l10n/messages_en.dart", "Dart", 0, 0, 2, -18, -1, -17
"/Users/carltonaikins/Desktop/Home/Programming/projects/budgetme/budgetme_mobileapp/lib/l10n/messages_es.dart", "Dart", 0, 0, 0, -18, -1, -19
"/Users/carltonaikins/Desktop/Home/Programming/projects/budgetme/budgetme_mobileapp/lib/l10n/messages_fr.dart", "Dart", 0, 0, 0, -18, -1, -19
"/Users/carltonaikins/Desktop/Home/Programming/projects/budgetme/budgetme_mobileapp/lib/l10n/messages_he.dart", "Dart", 0, 0, 0, -18, -1, -19
"/Users/carltonaikins/Desktop/Home/Programming/projects/budgetme/budgetme_mobileapp/lib/l10n/messages_ja.dart", "Dart", 0, 0, 0, -18, -1, -19
"/Users/carltonaikins/Desktop/Home/Programming/projects/budgetme/budgetme_mobileapp/lib/l10n/messages_ko.dart", "Dart", 0, 0, 0, -18, -1, -19
"/Users/carltonaikins/Desktop/Home/Programming/projects/budgetme/budgetme_mobileapp/lib/l10n/messages_pt.dart", "Dart", 0, 0, 0, -18, -1, -19
"/Users/carltonaikins/Desktop/Home/Programming/projects/budgetme/budgetme_mobileapp/lib/l10n/messages_ru.dart", "Dart", 0, 0, 0, -18, -1, -19
"/Users/carltonaikins/Desktop/Home/Programming/projects/budgetme/budgetme_mobileapp/lib/l10n/messages_zh.dart", "Dart", 0, 0, 0, -18, -1, -19
"/Users/carltonaikins/Desktop/Home/Programming/projects/budgetme/budgetme_mobileapp/lib/main.dart", "Dart", 0, 0, -1, 0, 0, -1
"/Users/carltonaikins/Desktop/Home/Programming/projects/budgetme/budgetme_mobileapp/lib/src/config/themes/text_theme.dart", "Dart", 0, 0, 1, 0, 0, 1
"/Users/carltonaikins/Desktop/Home/Programming/projects/budgetme/budgetme_mobileapp/lib/src/lang/budgetme_localizations.dart", "Dart", 0, 0, -1, 0, 0, -1
"/Users/carltonaikins/Desktop/Home/Programming/projects/budgetme/budgetme_mobileapp/lib/src/ui/views/create_goal_view/bottom_sheet_views/view_five.dart", "Dart", 0, 0, 3, 1, 2, 6
"/Users/carltonaikins/Desktop/Home/Programming/projects/budgetme/budgetme_mobileapp/lib/src/ui/views/create_goal_view/bottom_sheet_views/view_four.dart", "Dart", 0, 0, 1, 0, 0, 1
"/Users/carltonaikins/Desktop/Home/Programming/projects/budgetme/budgetme_mobileapp/lib/src/ui/views/create_goal_view/components/show_image_selection_bottom_sheet.dart", "Dart", 0, 0, 10, 6, 4, 20
"/Users/carltonaikins/Desktop/Home/Programming/projects/budgetme/budgetme_mobileapp/lib/src/ui/views/create_goal_view/create_goal_view.dart", "Dart", 0, 0, 1, 0, 0, 1
"/Users/carltonaikins/Desktop/Home/Programming/projects/budgetme/budgetme_mobileapp/lib/src/ui/views/goal_view/components/goal_view_header.dart", "Dart", 0, 0, 33, 0, 1, 34
"/Users/carltonaikins/Desktop/Home/Programming/projects/budgetme/budgetme_mobileapp/lib/src/ui/views/goal_view/goal_view.dart", "Dart", 0, 0, -11, -4, -2, -17
"Total", "-", 369, 92, 381, -101, 128, 869